10
100 32 53 98 97 13 1 79 38 56
88 86 98 8 62 54 68 33 63 14
81 1 49 42 2 66 28 68 83 56
49 71 75 40 93 23 91 85 6 45
4 94 9 15 59 55 29 89 25 100
61 24 46 21 93 45 30 4 30 58
81 24 95 30 20 71 51 89 45 21
81 2 25 96 38 62 4 44 22 64
1 85 77 24 38 34 67 48 12 52
75 38 60 30 24 7 42 25 2 91
10
