10
47 28 82 61 25 36 59 83 14 57
8 46 8 87 30 87 42 95 15 1
45 42 95 68 78 50 44 32 61 97
73 9 37 30 19 78 51 24 5 58
55 68 23 6 35 54 100 1 35 45
39 26 6 60 47 66 68 90 95 42
32 43 15 31 64 55 59 37 6 40
26 86 27 89 35 8 49 86 3 73
55 38 79 20 80 35 50 15 64 91
16 9 82 57 30 42 48 64 33 29
7
