8
45 60 55 76 77 65 28 82
80 60 87 64 26 69 38 80
2 77 22 6 5 92 84 42
25 27 6 56 39 7 89 55
62 27 69 100 16 75 42 29
42 93 51 61 15 21 37 22
96 87 50 61 31 40 8 80
39 17 41 85 8 4 7 19
4
