9
99 94 33 18 24 55 18 39 18
52 86 100 25 68 73 22 76 37
92 64 69 23 65 90 29 11 78
30 85 30 40 46 68 22 27 60
72 83 70 10 47 15 87 74 76
65 38 37 86 53 77 89 27 21
93 94 92 10 57 7 66 10 15
81 59 100 64 6 92 7 30 79
3 83 5 100 20 69 88 27 8
4
