8
41 27 78 23 74 60 38 49
21 70 5 79 11 53 44 50
84 1 28 80 60 10 42 88
87 78 17 97 81 60 13 20
33 33 21 23 22 31 2 89
75 52 1 47 6 73 98 66
98 39 19 46 24 75 47 20
28 34 38 80 99 42 68 2
7
