9
27 37 9 6 40 34 46 83 64
80 6 77 6 45 81 40 68 68
45 45 27 71 19 10 57 36 90
96 85 32 40 90 68 57 8 72
4 39 47 94 55 14 94 37 57
88 3 64 21 87 83 2 8 87
43 31 96 56 19 33 47 66 32
83 57 21 34 74 96 35 14 83
68 77 53 85 34 99 91 41 81
1
