9
89 65 4 63 59 47 50 53 37
24 84 20 11 14 9 39 96 82
100 60 94 20 55 64 95 6 22
95 68 54 4 42 68 37 92 23
51 57 97 23 32 84 63 5 59
90 38 24 91 11 51 81 97 9
86 82 66 61 67 29 74 59 74
39 52 61 3 47 62 86 17 33
93 24 46 56 49 40 43 93 72
