10
100 64 53 14 1 71 81 46 38 76
95 65 15 19 28 82 13 64 35 3
96 81 17 86 45 60 73 82 100 92
49 59 49 91 77 10 8 72 47 84
34 90 8 43 3 42 57 57 60 56
47 23 86 69 56 52 6 75 79 46
92 99 81 59 36 83 96 18 75 66
92 79 30 57 94 48 100 29 58 17
97 85 72 14 65 32 73 13 87 29
63 86 44 36 51 57 41 5 4 29
