9
60 12 25 5 51 81 18 74 48
42 8 61 77 61 16 42 9 21
84 55 44 17 15 56 23 49 74
66 72 89 51 59 55 20 76 19
46 72 43 44 77 28 11 28 24
45 15 32 47 77 58 39 12 34
12 35 85 89 22 77 13 49 46
14 43 19 6 9 82 61 79 45
22 89 85 22 20 18 86 76 15
