8
86 80 47 85 65 61 47 57
10 98 19 59 36 42 21 39
86 40 9 25 32 82 79 25
77 8 78 77 10 59 85 86
29 90 19 21 23 60 98 59
28 5 46 33 40 29 87 91
52 19 22 18 20 21 97 19
78 84 61 59 96 22 44 80
