9
89 86 39 44 20 97 22 25 1
85 36 21 59 54 52 14 80 11
73 93 89 51 69 7 51 9 55
39 81 57 76 32 44 66 74 81
76 98 46 16 16 9 85 47 95
20 37 72 86 49 74 100 79 71
97 78 84 84 63 20 70 71 86
12 25 73 33 96 75 10 33 6
61 42 10 87 23 61 24 59 39
