8
33 68 78 87 18 83 59 80
58 94 98 53 16 20 84 71
2 1 79 11 79 100 83 23
32 23 35 93 5 2 11 37
58 18 80 79 46 11 56 26
88 40 41 50 1 42 63 26
1 73 8 57 80 68 12 46
59 36 8 97 44 18 57 17
