8
62 72 96 18 56 58 59 79
32 2 82 41 84 39 87 93
47 76 17 99 92 9 88 51
12 17 93 62 56 68 33 82
9 28 3 14 33 8 58 82
44 77 54 38 74 29 11 76
4 29 41 87 43 30 10 86
41 6 7 8 26 38 44 90
