10
10 33 40 68 33 91 58 89 61 57
77 75 94 50 66 24 90 44 9 94
74 70 23 91 95 26 33 100 85 68
22 90 35 10 13 89 58 43 18 54
92 2 71 27 36 68 2 86 3 1
42 45 33 47 50 54 57 99 36 81
12 26 83 24 13 96 51 99 19 73
24 59 5 11 72 68 7 50 97 40
61 42 58 58 73 43 98 10 68 37
15 11 89 17 34 62 18 94 31 26
