9
65 62 88 59 10 94 54 40 15
58 8 58 57 50 23 100 27 4
69 40 50 24 74 37 22 16 94
65 70 84 85 35 10 11 79 12
15 96 34 75 22 68 96 24 28
1 74 8 32 72 15 51 83 18
84 49 66 93 71 23 76 93 5
22 32 100 80 74 63 80 34 18
66 65 80 18 69 36 74 64 20
