10
95 96 80 56 85 24 16 63 45 18
89 51 62 99 21 7 54 63 40 21
24 12 15 20 29 13 100 51 82 80
100 46 48 38 81 3 72 38 97 91
34 49 32 34 31 33 92 34 38 92
39 44 100 18 29 22 46 4 48 18
97 93 96 76 5 84 45 65 64 98
27 50 27 71 20 80 17 40 53 82
47 9 77 3 45 96 98 60 78 34
36 12 30 100 87 80 77 7 93 18
