31
9657 3580 2851 546 6390 8410 1660 1405 9081 4923 973 8592 4159 2840 6154 9983 5496 4612 17 4940 3267 8746 790 1862 4424 2145 7278 7123 5257 3831 3580
2520 8991 2989 3815 6359 7122 4571 2582 2526 9099 4106 2373 1111 9170 494 9369 3957 8186 473 2516 2234 7491 226 2468 563 6329 9565 2116 8961 4185 3834
8999 1766 6894 4031 7082 7281 175 8407 1409 7760 7805 9645 5745 3921 2107 6271 7227 4738 9039 7931 3603 6644 1408 1444 4030 8640 4862 4358 469 2004 4482
6123 8908 6538 8941 9537 3522 9514 5680 6585 7030 8600 6201 5774 589 7557 9869 3349 4927 7027 4500 4221 7391 945 8258 2754 5507 1501 3818 9108 7524 8365
8338 6515 4562 4054 3352 4824 6689 4985 1169 3632 4181 7804 3267 7530 2713 5306 1841 376 2451 5611 7602 1530 8616 963 13 182 6255 9763 6889 2331 3991
6765 7782 90 8640 3732 5953 592 2042 8804 9353 9253 688 4908 5404 613 5641 5498 2975 445 6868 2144 558 1762 7491 1038 4317 4458 4585 916 4954 7912
8305 5307 9145 542 5934 4032 3205 2367 894 2364 3493 5774 8347 3193 3188 1224 4367 8960 3754 2095 2710 1985 8157 3487 1969 2562 5340 2241 8953 8833 7177
420 9785 682 2012 9049 4746 8165 9338 9931 3303 8795 4848 2841 2149 4474 7044 9147 4390 8792 3860 1804 7389 924 5060 212 6553 1513 661 4485 4537 9400
9933 4250 844 239 5094 8805 2138 995 6382 7924 9468 5754 2464 5174 4993 1372 101 1643 4694 9554 4499 6671 9983 5930 6765 3677 6074 8653 4792 72 653
637 5821 5295 1772 4693 4101 146 595 2944 4026 7845 4189 3762 8233 5847 6243 9414 9326 2740 6578 5545 9357 6971 4600 1899 238 5650 5488 9874 9006 334
424 2496 5255 951 1658 9413 1723 4285 3951 330 985 3730 6278 8696 4144 435 3075 8567 8031 144 851 9313 503 3889 4301 607 2453 4930 8082 2820 2562
3532 2082 3257 7614 4969 1345 8951 2937 6031 6719 7204 7319 9647 3870 4153 3265 3846 6519 1214 542 5648 4913 2874 5531 6623 4216 1508 3210 5067 4849 9379
7262 5680 8930 5572 4254 8622 1175 8751 3355 9309 4154 9884 3746 5626 2201 4105 7926 8310 8880 7080 7405 7716 8164 7680 3625 4840 2575 8228 8135 9875 3952
5486 6029 6404 785 8813 4117 4406 7452 5718 2547 9748 530 1035 9679 8155 2381 9800 5786 7782 5754 5091 3425 3300 2009 9176 6739 9992 2360 4436 7184 9677
8523 9851 8915 2650 9802 2724 1311 6770 5194 6308 3176 35 3057 4746 298 8648 6817 8049 4008 725 6257 6983 9463 8202 4021 145 1096 6258 7456 5832 7488
1491 463 8324 1838 4396 9445 8037 4520 2040 8873 106 2645 3875 6792 7297 3659 1032 4438 1449 8597 3357 4559 1069 9818 8253 5773 5704 7680 2773 4056 81
3094 8684 5842 3222 252 5257 2060 7695 818 3867 7155 2537 1585 6030 2969 8319 2527 5986 802 9767 9539 9291 6268 4522 7620 9522 2303 2239 3218 9893 2873
5589 9909 7863 3705 5091 4021 1322 35 9146 1679 3480 6766 5021 729 432 737 8841 3756 6311 7306 4965 8690 8247 913 2118 140 7012 1321 7625 1516 75
2136 8215 4500 4953 1887 4173 3043 5813 7229 3966 9478 9741 2307 306 8423 5394 3271 4981 8922 4373 5234 5834 8537 2862 2298 6832 3269 5988 4917 6603 1850
1877 3979 1106 5129 300 2193 1745 372 4913 7731 6705 9067 3963 1309 9844 8466 6425 5507 3373 1112 5302 4853 4799 8804 9280 4365 907 9394 2618 6303 7298
7785 5813 7898 5250 4824 4969 4278 574 6856 4849 7816 3347 1233 526 2800 6392 7240 8488 9949 5417 1760 2985 3323 1341 282 19 6401 8647 1793 2865 3048
1583 6224 5497 167 9960 7436 327 7242 7381 7724 4315 8258 9878 8463 9807 9092 7084 2278 2926 7474 355 3300 7246 7556 5758 2735 3321 335 1230 7472 3300
1751 4039 8005 9182 9623 7348 6632 1267 9589 4077 4138 8107 2103 8868 430 8435 9249 1122 7528 2152 8318 1155 841 6991 4640 8731 2026 8186 852 391 807
4263 492 5460 3527 9343 6516 1243 8815 5040 6676 8828 153 3869 8951 6099 9855 4701 113 7008 1612 2171 7889 9350 9514 7485 9199 2823 6019 2781 9078 8309
9977 7735 8234 7790 4121 8088 1393 1053 5247 7075 8590 5385 252 8814 9976 2031 5771 3429 3218 6042 3643 3520 5466 1371 800 5136 8460 2114 3000 7733 3979
153 7477 344 5991 2454 8459 3862 8130 3485 1746 5162 8005 4870 1302 8164 7653 3591 4615 1965 6515 5968 7308 7623 4456 4540 1768 6480 44 5288 5677 2526
7859 1662 1126 7186 5622 2711 9358 5085 1499 5066 2383 1778 3246 8020 4662 9660 8297 7304 744 6195 3631 9339 4252 4769 6535 197 6620 9601 9069 5916 4806
1001 1288 9282 866 8217 2221 6697 3796 4774 9992 7522 6614 7467 985 5440 1031 4087 7124 349 3552 4289 6047 9753 2556 332 9766 9563 5243 7372 6318 2021
9749 3738 9116 1556 5353 2576 6815 1207 6696 6384 3392 708 6827 4787 2695 3018 1652 7285 292 4039 7313 3069 6302 3980 535 5065 3600 126 3740 4793 1045
5952 138 849 5776 2321 7246 8140 7991 8248 4895 2478 9081 8576 7882 8175 2798 4456 3367 5162 8242 3287 6293 6053 2376 3660 9972 2915 5501 8936 2433 8008
5910 9578 9462 476 4561 6016 271 9649 7706 169 2762 9866 8962 8010 5108 5361 9663 8653 7903 56 9930 9947 8283 7069 5288 9331 2136 4671 4358 4916 8293
